2
11
11
H..........
##.#######.
...........
.##########
...........
####T#####.
...........
.#######M##
......#...T
###.#######
0..........
2
Armor
This is armor
23
Sword
This is sword
12